###################
#                 #
#                 #
#   #         #   #
# @ #         # @ #
#   #         #   #
#                 #
#                 #
###################
