###############################
###############################
#                             #
#                             #
#                             #
#             #               #
#             #               #
#             #               #
#                             #
#   #                     #   #
# @ #                     # @ #
#   #                     #   #
#                             #
#             #               #
#             #               #
#             #               #
#                             #
#                             #
#                             #
###############################
