###############################
###############################
#                             #
#                             #
#                             #
#             ##              #
#             ##              #
#             ##              #
#                             #
#   #    ##          ##   #   #
# @ #    ##          ##   # @ #
#   #    ##          ##   #   #
#                             #
#             ##              #
#             ##              #
#             ##              #
#                             #
#                             #
#                             #
###############################
