###############################
###############################
#                             #
#                             #
#                             #
#             ##              #
#             ##              #
#             ##              #
#                             #
#   #4                   1#   #
# @ #5                   2# @ #
#   #6                   3#   #
#                             #
#             ##              #
#             ##              #
#             ##              #
#                             #
#                             #
#                             #
###############################
