###############################
###############################
#                             #
#  @ #       ##########       #
#    #       ##########       #
#    #                        #
#                             #
#                     #       #
#                     #       #
#            ##       #       #
#            ##       #       #
#     #                       #
#     #                       #
#     #                       #
#     #                  ##   #
#                        ##   #
#     #########          #    #
#     #########            @  #
#                             #
###############################
