###################################################
###################################################
#                                                 #
#                                                 #
#                 #######################         #
#                 #                     #         #
#                                       #         #
#                       @               #         #
#                                       #         #
#     #############                               #
#                 #                               #
#                 #                               #
#                 #                     #         #
#                 #########   ###############     #
#              @  #           #                   #
#                 #           #                   #
#                 #           #   @               #
#                 #           #                   #
#            ######    ########                   #
#                             #                   #
####                          #####               #
#             #                                   #
#             #         @                         #
#             #               #                   #
#                             #                   #
#        #############    ##############          #
#                                                 #
#                                                 #
#                                                 #
#                                                 #
#                                                 #
###################################################
