###################################################
###################################################
#                        #                        #
#                    @                            #
#                                #                #
#      #######           #       #                #
#                        #       #                #
#                        #                        #
#             ############                        #
#                                                 #
#                                                 #
#                   #         #      #            #
#######             #         #      #        @   #
#                 ###         #      #            #
#            #                #      #            #
#            #                #      #            #
#######    ###                #      #######    ###
#            #                #                   #
#            #                                    #
#                                                 #
#    ####                                #######  #
#                                                 #
#                 #####                           #
##      #####                                     #
#           #                                     #
# @         #            ###########              #
#           #     #      #                        #
#                 #      #                        #
#                 #                               #
#                 #         @                     #
#                        #                        #
###################################################
