###############################
###############################
#                             #
#                             #
#                             #
#             ##              #
#             ##              #
#             ##              #
#                             #
#   #                     #   #
# @ #                     # @ #
#   #                     #   #
#                             #
#             ##              #
#             ##              #
#             ##              #
#                             #
#                             #
#                             #
###############################
