###############################
###############################
#                             #
#  @ #                        #
#    #       ##########       #
#   ##                        #
#                             #
#                     #       #
#                     #       #
#            ##       #       #
#            ##       #       #
#     #                       #
#     #                       #
#     #                       #
#     #                       #
#                        ###  #
#                        #    #
#     #########          # @  #
#                             #
###############################
