###################################################
###################################################
#            #                       #            #
# @          #                       #          @ #
#            #                       #            #
#                                                 #
#                                                 #
#                                                 #
#            #                       #            #
#            #                       #            #
#            #                       #            #
#                                                 #
#                                                 #
#                                                 #
#                                                 #
#                                                 #
##############                       ##############
#                                                 #
#                                                 #
#                                                 #
#                                                 #
#                                                 #
#            #                       #            #
#            #                       #            #
#            #                       #            #
#                                                 #
#                                                 #
#                                                 #
#            #                       #            #
# @          #                       #          @ #
#            #                       #            #
###################################################
