###################################################
###################################################
#                        #                        #
#                    @   #                        #
#                        #                        #
#                        #                        #
#                        #                        #
#                        #                        #
#                        #                        #
#                        #                        #
#                        #                        #
#                  #############                  #
#                                             @   #
#                                                 #
#            #                       #            #
#            #                       #            #
##############                       ##############
#            #                       #            #
#            #                       #            #
#                                                 #
#                                                 #
#                                                 #
#                  #############                  #
#                        #                        #
#                        #                        #
# @                      #                        #
#                        #                        #
#                        #                        #
#                        #                        #
#                        #  @                     #
#                        #                        #
###################################################
